x;y;des;player;id
7;5;2;1;0
1;9;2;1;1
7;2;2;1;2
6;1;2;1;3
9;2;8;1;4
1;7;2;1;5
9;3;2;2;6
6;3;2;2;7
8;2;2;2;8
8;9;2;2;9
2;5;2;2;10
4;7;2;2;11
